4 4 4 4 4 4 4 4 4 4 4 4 4 4 4 4
4 4 4 4 4 4 4 4 4 4 4 4 4 4 4 4
4 4 4 4 4 4 4 4 4 4 4 4 4 4 4 4
4 4 4 4 4 4 4 4 4 4 4 4 4 4 4 4
4 4 4 4 4 4 4 4 4 4 4 4 4 4 4 4
4 4 4 4 4 4 4 4 4 4 4 4 4 4 4 4
0 1 1 1 1 1 1 1 1 1 1 1 2 4 4 4
3 4 4 4 4 4 4 4 4 4 4 4 5 4 4 4
3 4 4 4 4 4 4 4 4 4 4 4 5 4 4 4
3 4 4 4 4 4 4 4 4 4 4 4 5 4 4 4
3 4 4 4 4 4 4 4 4 4 4 4 5 4 4 4
6 7 7 7 7 7 7 7 7 7 7 7 8 4 4 4